Конструкторы
  	Имя	Описание
	LinearGradientBrush	Перегружен. Инициализирует новый экземпляр класса LinearGradientBrush с указанными точками и цветами.

///////////////////

Методы
  	Имя	Описание
	Clone	Создает точную копию этого объекта LinearGradientBrush. (Переопределяет Brush.Clone.)
	CreateObjRef	Создает объект, который содержит всю необходимую информацию для создания прокси-сервера, используемого для взаимодействия с удаленным объектом. (Унаследовано от MarshalByRefObject.)
	Dispose	Перегружен. 
	Equals	Определяет, равен ли заданный объект Object текущему объекту Object. (Унаследовано от Object.)
	Finalize	Позволяет объекту Object попытаться освободить ресурсы и выполнить другие операции очистки, перед тем как объект Object будет утилизирован в процессе сборки мусора. (Унаследовано от Brush.)
	GetHashCode	Играет роль хэш-функции для определенного типа. (Унаследовано от Object.)
	GetLifetimeService	Извлекает объект обслуживания во время существования, который управляет политикой времени существования данного экземпляра. (Унаследовано от MarshalByRefObject.)
	GetType	Возвращает объект Type для текущего экземпляра. (Унаследовано от Object.)
	InitializeLifetimeService	Возвращает объект обслуживания во время существования для управления политикой времени существования данного экземпляра. (Унаследовано от MarshalByRefObject.)
	MemberwiseClone	Перегружен. 
	MultiplyTransform	Перегружен. Умножает объект Matrix, представляющий локальное геометрическое преобразование объекта LinearGradientBrush, на указанный объект Matrix, добавляя указанный объект Matrix.
	ResetTransform	Возвращает свойству Transform единичное значение.
	RotateTransform	Перегружен. Поворачивает локальное геометрическое преобразование на заданную величину. Этот метод добавляет поворот к преобразованию.
	ScaleTransform	Перегружен. Масштабирует локальное геометрическое преобразование на заданные величины. Этот метод добавляет в преобразование масштабирующую матрицу.
	SetBlendTriangularShape	Перегружен. Создает линейный градиент с цветом центра и линейным спадом к одному цвету на обоих концах.
	SetNativeBrush	В производном классе определяет ссылку на объект-кисть GDI+. (Унаследовано от Brush.)
	SetSigmaBellShape	Перегружен. Создает градиентный переход, основанный на колоколообразной кривой.
	ToString	Возвращает объект String, который представляет текущий объект Object. (Унаследовано от Object.)
	TranslateTransform	Перегружен. Выполняет смещение локального геометрического преобразования в заданных измерениях. Этот метод добавляет смещение к преобразованию.

////////////////////////

Свойства
  	Имя	Описание
	Blend	Получает или задает объект Blend, определяющий позиции и коэффициенты, задающие настраиваемый спад для градиента.
	GammaCorrection	Получает или задает значение, указывающее, включена ли гамма-коррекция для этого объекта LinearGradientBrush.
	InterpolationColors	Получает или задает объект ColorBlend, определяющий многоцветный линейный градиент.
	LinearColors	Получает или задает начальный и конечный цвета градиента.
	Rectangle	Получает прямоугольную область, которая определяет начальную и конечную точки градиента.
	Transform	Получает или задает копию объекта Matrix, определяющего локальное геометрическое преобразование для этого объекта LinearGradientBrush.
	WrapMode	Получает или задает перечисление WrapMode, определяющее режим переноса для этого объекта LinearGradientBrush.