Конструкторы
  	Имя	Описание
	PathGradientBrush	Перегружен. Инициализирует новый экземпляр класса PathGradientBrush с указанным контуром.

Список перегрузки
  	Имя	Описание
	PathGradientBrush(GraphicsPath)	Инициализирует новый экземпляр класса PathGradientBrush с указанным контуром.
	PathGradientBrush(Point())	Инициализирует новый экземпляр класса PathGradientBrush с указанными точками.
	PathGradientBrush(PointF())	Инициализирует новый экземпляр класса PathGradientBrush с указанными точками.
	PathGradientBrush(Point(), WrapMode)	Инициализирует новый экземпляр класса PathGradientBrush с указанными точками и режимом переноса.
	PathGradientBrush(PointF(), WrapMode)	Инициализирует новый экземпляр класса PathGradientBrush с указанными точками и режимом переноса.
//////////////////////////

Методы
  	Имя	Описание
	Clone	Создает точную копию данного объекта PathGradientBrush. (Переопределяет Brush.Clone.)
	CreateObjRef	Создает объект, который содержит всю необходимую информацию для создания прокси-сервера, используемого для взаимодействия с удаленным объектом. (Унаследовано от MarshalByRefObject.)
	Dispose	Перегружен. 
	Equals	Определяет, равен ли заданный объект Object текущему объекту Object. (Унаследовано от Object.)
	Finalize	Позволяет объекту Object попытаться освободить ресурсы и выполнить другие операции очистки, перед тем как объект Object будет утилизирован в процессе сборки мусора. (Унаследовано от Brush.)
	GetHashCode	Играет роль хэш-функции для определенного типа. (Унаследовано от Object.)
	GetLifetimeService	Извлекает объект обслуживания во время существования, который управляет политикой времени существования данного экземпляра. (Унаследовано от MarshalByRefObject.)
	GetType	Возвращает объект Type для текущего экземпляра. (Унаследовано от Object.)
	InitializeLifetimeService	Возвращает объект обслуживания во время существования для управления политикой времени существования данного экземпляра. (Унаследовано от MarshalByRefObject.)
	MemberwiseClone	Перегружен. 
	MultiplyTransform	Перегружен. Умножает объект Matrix, представляющий локальное геометрическое преобразование объекта PathGradientBrush, на указанный объект Matrix, добавляя указанный объект Matrix.
	ResetTransform	Возвращает свойству Transform единичное значение.
	RotateTransform	Перегружен. Применяет поворот по часовой стрелке на указанный угол к локальному геометрическому преобразованию.
	ScaleTransform	Перегружен. Масштабирует локальное геометрическое преобразование на заданные величины. Этот метод добавляет в преобразование масштабирующую матрицу.
	SetBlendTriangularShape	Перегружен. Создает градиент с цветом центра и линейным переходом к одному окружающему цвету.
	SetNativeBrush	В производном классе определяет ссылку на объект-кисть GDI+. (Унаследовано от Brush.)
	SetSigmaBellShape	Перегружен. Создает градиентный переход между центральным цветом и первым окружающим цветом на основе колоколообразной кривой.
	ToString	Возвращает объект String, который представляет текущий объект Object. (Унаследовано от Object.)
	TranslateTransform	Перегружен. Применяет указанный сдвиг к локальному геометрическому преобразованию. Этот метод добавляет сдвиг к преобразованию.

//////////////////////

Свойства
  	Имя	Описание
	Blend	Получает или задает объект Blend, определяющий позиции и коэффициенты, задающие настраиваемый спад для градиента.
	CenterColor	Получает или задает цвет в центре градиента контура.
	CenterPoint	Получает или задает центральную точку градиента контура.
	FocusScales	Получает или задает точку фокуса для градиентного перехода.
	InterpolationColors	Получает или задает объект ColorBlend, определяющий многоцветный линейный градиент.
	Rectangle	Получает ограничивающий прямоугольник для этого объекта PathGradientBrush.
	SurroundColors	Получает или задает мас??ив цветов, соответствующих точкам контура, заполняемого объектом PathGradientBrush.
	Transform	Получает или задает копию объекта Matrix, определяющего локальное геометрическое преобразование для этого объекта PathGradientBrush.
	WrapMode	Получает или задает объект WrapMode, определяющий режим переноса для этого объекта PathGradientBrush.