DataGridViewCell - класс

Представляет отдельную ячейку в элементе управления DataGridView.

Конструкторы

 DataGridViewCell	Инициализирует новый экземпляр класса DataGridViewCell.

Методы

 AdjustCellBorderStyle	Изменяет стиль границ входной ячейки в соответствии с указанными критериями.
 BorderWidths	Возвращает объект Rectangle, представляющий значения ширины всех полей ячейки.
 ClickUnsharesRow	Показывает, будет ли отменен общий доступ к строке ячейки, если щелкнуть ячейку.
 Clone	Создает точную копию данной ячейки.
 ContentClickUnsharesRow	Показывает, будет ли отменен общий доступ к строке ячейки, если щелкнуть содержимое ячейки.
 ContentDoubleClickUnsharesRow	Показывает, будет ли отменен общий доступ к строке ячейки по двойному щелчку содержимого ячейки.
 CreateAccessibilityInstance	Создает новый доступный объект для DataGridViewCell.
 DetachEditingControl	Удаляет элемент управления "Поле ввода" ячейки из объекта DataGridView.
 Dispose	Перегружен. Освобождает ресурсы, используемые объектом DataGridViewCell.
 DoubleClickUnsharesRow	Показывает, будет ли отменен общий доступ к строке ячейки по двойному щелчку ячейки.
 EnterUnsharesRow	Показывает, будет ли отменен общий доступ к родительской строке при перемещении фокуса на ячейку.
 Equals	Определяет, равен ли заданный объект Object текущему объекту Object. (Унаследовано от Object.)
 Finalize	Освобождает неуправляемые ресурсы и выполняет другие операции очистки, перед тем как объект DataGridViewCell будет утилизирован во время сборки мусора. (Переопределяет Object.Finalize().)
 GetClipboardContent	Извлекает форматированное значение ячейки для копирования в объект Clipboard.
 GetContentBounds	Перегружен. Возвращает прямоугольник, ограничивающий область содержимого ячейки.
 GetEditedFormattedValue	Возвращает текущее форматированное значение ячейки независимо от того, находится ли ячейка в режиме редактирования, и что значение не было зафиксировано.
 GetErrorIconBounds	Возвращает прямоугольник, ограничивающий значок ошибки ячейки, если такой отображается.
 GetErrorText	Возвращает строку, представляющую ошибку для ячейки.
 GetFormattedValue	Получает значение ячейки, отформатированное для отображения.
 GetHashCode	Играет роль хэш-функции для определенного типа. (Унаследовано от Object.)
 GetInheritedContextMenuStrip	Получает наследуемое контекстное меню для текущей ячейки.
 GetInheritedState	Возвращает значение, показывающее текущее состояние ячейки, как наследуемое от состояния ее строки и столбца.
 GetInheritedStyle	Получает стиль, примененный к ячейке.
 GetPreferredSize	Вычисляет предпочтительный размер (в точках) ячейки.
 GetSize	Получает размер ячейки.
 GetType	Возвращает объект Type для текущего экземпляра. (Унаследовано от Object.)
 GetValue	Получает значение ячейки.
 InitializeEditingControl	Инициализирует элемент управления, используемый для изменения ячейки.
 KeyDownUnsharesRow	Показывает, отменяется ли общий доступ к родительской строке при нажатии пользователем клавиши, когда фокус установлен на ячейку.
 KeyEntersEditMode	Определяет, должен ли режим редактирования запускаться на основе заданной клавиши.
 KeyPressUnsharesRow	Указывает, будет ли отменен общий доступ к строке, если нажать клавишу, когда фокус установлен на ячейку в строке.
 KeyUpUnsharesRow	Показывает, будет ли отменен общий доступ к родительской строке при отпускании пользователем клавиши, когда фокус установлен на ячейку.
 LeaveUnsharesRow	Показывает, будет ли отменен общий доступ к строке при уходе фокуса с ячейки в строке.
 MeasureTextHeight	Перегружен. Получает высоту в точках заданного текста.
 MeasureTextPreferredSize	Получает идеальные значения высоты и ширины заданного текста при указанных характеристиках.
 MeasureTextSize	Получает значения высоты и ширины заданного текста при указанных характеристиках.
 MeasureTextWidth	Получает ширину (в точках) заданного текста при указанных характеристиках.
 MemberwiseClone	Создает неполную копию текущего объекта Object. (Унаследовано от Object.)
 MouseClickUnsharesRow	Показывает, будет ли отменен общий доступ к строке по щелчку пользователем кнопки мыши, когда указатель установлен на ячейку в строке.
 MouseDoubleClickUnsharesRow	Показывает, будет ли отменен общий доступ к строке, когда пользователь дважды щелкает ячейку в этой строке.
 MouseDownUnsharesRow	Указывает, будет ли отменен общий доступ к строке при удерживании пользователем кнопки мыши, когда указатель наведен на ячейку в строке.
 MouseEnterUnsharesRow	Указывает, будет ли отменен общий доступ к строке при перемещении указателя мыши на ячейку в строке.
 MouseLeaveUnsharesRow	Указывает, будет ли отменен общий доступ к строке, когда указатель мыши перемещается со строки.
 MouseMoveUnsharesRow	Указывает, будет ли отменен общий доступ к строке при перемещении указателя мыши на ячейку в строке.
 MouseUpUnsharesRow	Указывает, будет ли отменен общий доступ к строке при отпускании пользователем кнопки мыши, когда указатель установлен на ячейку в строке.
 OnClick	Вызывается по щелчку ячейки.
 OnContentClick	Вызывается по щелчку содержимого ячейки.
 OnContentDoubleClick	Вызывается по двойному щелчку содержимого ячейки.
 OnDataGridViewChanged	Вызывается при изменении свойства DataGridView ячейки. (Переопределяет DataGridViewElement.OnDataGridViewChanged().)
 OnDoubleClick	Вызывается по двойному щелчку ячейки.
 OnEnter	Вызывается при перемещении фокуса на ячейку.
 OnKeyDown	Вызывается при нажатии клавиши знака, когда фокус установлен на ячейку.
 OnKeyPress	Вызывается при нажатии клавиши, когда фокус установлен на ячейку.
 OnKeyUp	Вызывается при отпускании клавиши знака, когда фокус установлен на ячейку.
 OnLeave	Вызывается при перемещении фокуса с ячейки.
 OnMouseClick	Вызывается по щелчку пользователем кнопки мыши, когда указатель наведен на ячейку.
 OnMouseDoubleClick	Вызывается по двойному щелчку пользователем кнопки мыши, когда указатель наведен на ячейку.
 OnMouseDown	Вызывается при удерживании пользователем кнопки мыши, когда указатель наведен на ячейку.
 OnMouseEnter	Вызывается при перемещении указателя мыши на ячейку.
 OnMouseLeave	Вызывается, когда указатель мыши покидает ячейку.
 OnMouseMove	Вызывается при перемещении указателя мыши внутри ячейки.
 OnMouseUp	Вызывается при отпускании пользователем кнопки мыши, когда указатель наведен на ячейку.
 Paint	Закрашивает текущую ячейку DataGridViewCell.
 PaintBorder	Окрашивает границу текущей ячейки DataGridViewCell.
 PaintErrorIcon	Окрашивает значок ошибки текущей ячейки DataGridViewCell.
 ParseFormattedValue	Преобразует значение, отформатированное для отображения, в реальное значение ячейки.
 PositionEditingControl	Задает местоположение и размер элемента управления "Поле ввода", размещаемого ячейкой в элементе управления DataGridView.
 PositionEditingPanel	Задает местоположение и размер панели редактирования, размещаемой ячейкой, и возвращает нормальные границы элемента управления "Поле ввода" в панели редактирования.
 RaiseCellClick	Вызывает событие DataGridView.CellClick. (Унаследовано от DataGridViewElement.)
 RaiseCellContentClick	Вызывает событие DataGridView.CellContentClick. (Унаследовано от DataGridViewElement.)
 RaiseCellContentDoubleClick	Вызывает событие DataGridView.CellContentDoubleClick. (Унаследовано от DataGridViewElement.)
 RaiseCellValueChanged	Вызывает событие DataGridView.CellValueChanged. (Унаследовано от DataGridViewElement.)
 RaiseDataError	Вызывает событие DataGridView.DataError. (Унаследовано от DataGridViewElement.)
 RaiseMouseWheel	Вызывает событие Control.MouseWheel. (Унаследовано от DataGridViewElement.)
 SetValue	Устанавливает значение ячейки.
 ToString	Возвращает строку, которая описывает текущий объект. (Переопределяет Object.ToString().)

Свойства

 AccessibilityObject	Получает значение DataGridViewCell.DataGridViewCellAccessibleObject, присвоенное объекту DataGridViewCell.
 ColumnIndex	Получает индекс столбца для данной ячейки.
 ContentBounds	Получает прямоугольник, ограничивающий область содержимого ячейки.
 ContextMenuStrip	Получает или задает контекстное меню, связанное с ячейкой.
 DataGridView	Получает элемент управления DataGridView, связанный с данным элементом. (Унаследовано от DataGridViewElement.)
 DefaultNewRowValue	Получает значение по умолчанию для ячейки в строке для новых записей.
 Displayed	Получает значение, показывающее, отображается ли в текущий момент ячейка на экране.
 EditedFormattedValue	Получает текущее форматированное значение ячейки независимо от того, находится ли ячейка в режиме редактирования, и что значение не зафиксировано.
 EditType	Получает тип размещенного элемента управления "Поле ввода", который относится к ячейке.
 ErrorIconBounds	Получает границы значка ошибки для ячейки.
 ErrorText	Получает или задает текст, описывающий условие ошибки, связанное с ячейкой.
 FormattedValue	Получает значение ячейки, отформатированное для отображения.
 FormattedValueType	Получает тип форматированного значения, связанного с ячейкой.
 Frozen	Получает значение, указывающее, заморожена ли ячейка.
 HasStyle	Получает значение, показывающее, было ли установлено свойство Style.
 InheritedState	Получает текущее состояние ячейки, как наследуемое от состояния ее строки и столбца.
 InheritedStyle	Получает стиль, применяемый в текущий момент к ячейке.
 IsInEditMode	Получает значение, показывающее, редактируется ли данная ячейка в текущий момент.
 OwningColumn	Получает столбец, в котором содержится данная ячейка.
 OwningRow	Получает строку, содержащую эту ячейку.
 PreferredSize	Получает размер (в точках) прямоугольной области, в которую может быть вписана ячейка.
 ReadOnly	Получает или задает значение, показывающее, можно ли изменять данные в ячейке.
 Resizable	Получает значение, указывающее возможность изменения размеров ячейки.
 RowIndex	Получает индекс родительской строки ячейки.
 Selected	Получает или задает значение, указывающее, была ли выбрана ячейка.
 Size	Получает размер ячейки.
 State	Получает состояние пользовательского интерфейса для элемента. (Унаследовано от DataGridViewElement.)
 Style	Получает или задает стиль ячейки.
 Tag	Получает или задает объект, содержащий дополнительные данные о ячейке.
 ToolTipText	Получает или задает текст всплывающей подсказки, связанной с этой ячейкой.
 Value	Получает или задает значение, связанное с этой ячейкой.
 ValueType	Получает или задает тип данных для значений в ячейке.
 Visible	Получает значение, указывающее, находится ли ячейка в скрытой строке или скрытом столбце.