Конструкторы

/////////////////////


  	Имя	Описание
	Timer	Инициализирует новый экземпляр класса Timer.
	Timer(IContainer)	Инициализирует новый экземпляр класса Timer вместе с указанным контейнером.

Методы

/////////////////////


  	Имя	Описание
	CreateObjRef	Создает объект, который содержит всю необходимую информацию для создания прокси-сервера, используемого для взаимодействия с удаленным объектом. (Унаследовано от MarshalByRefObject.)
	Dispose	Освобождает все ресурсы, используемые объектом Component. (Унаследовано от Component.)
	Dispose(Boolean)	Освобождает используемые таймером ресурсы, кроме памяти. (Переопределяет Component.Dispose(Boolean).)
	Equals(Object)	Определяет, равен ли заданный объект Object текущему объекту Object. (Унаследовано от Object.)
	Finalize	Освобождает неуправляемые ресурсы и выполняет другие операции очистки перед тем, как объект Component будет освобожден при сборке мусора. (Унаследовано от Component.)
	GetHashCode	Играет роль хэш-функции для определенного типа. (Унаследовано от Object.)
	GetLifetimeService	Извлекает объект обслуживания во время существования, который управляет политикой времени существования данного экземпляра. (Унаследовано от MarshalByRefObject.)
	GetService	Возвращает объект, представляющий службу, обеспечиваемую компонентом Component или его контейнером Container. (Унаследовано от Component.)
	GetType	Возвращает объект Type для текущего экземпляра. (Унаследовано от Object.)
	InitializeLifetimeService	Возвращает объект обслуживания во время существования для управления политикой времени существования данного экземпляра. (Унаследовано от MarshalByRefObject.)
	MemberwiseClone	Создает неполную копию текущего объекта Object. (Унаследовано от Object.)
	MemberwiseClone(Boolean)	Создает неполную копию текущего объекта MarshalByRefObject. (Унаследовано от MarshalByRefObject.)
	OnTick	Вызывает событие Tick.
	Start	Запускает таймер.
	Stop	Останавливает таймер.
	ToString	Инфраструктура. Возвращает строку, представляющую объект Timer. (Переопределяет Component.ToString.)

Свойства

//////////////////////////


  	Имя	Описание
	CanRaiseEvents	Возвращает значение, показывающее, может ли компонент вызывать событие. (Унаследовано от Component.)
	Container	Возвращает контейнер IContainer, содержащий компонент Component. (Унаследовано от Component.)
	DesignMode	Возвращает значение, указывающее, находится ли данный компонент Component в режиме конструктора в настоящее время. (Унаследовано от Component.)
	Enabled	Возвращает или задает признак активности таймера.
	Events	Возвращает список обработчиков событий, которые прикреплены к этому объекту Component. (Унаследовано от Component.)
	Interval	Возвращает или задает время в миллисекундах до вызова события Tick относительно момента, когда событие Tick произошло последний раз.
	Site	Получает или задает экземпляр ISite для компонента Component. (Унаследовано от Component.)
	Tag	Возвращает или задает произвольную строку, представляющую некоторый тип состояния пользователя.


/////////////////////////////

События
  	Имя	Описание
	Disposed	Происходит при удалении компонента вызовом метода Dispose. (Унаследовано от Component.)
	Tick	Происходит по истечении заданного интервала таймера при условии, что таймер включен.